,Superstep,ActivePartitions,ActiveVM,MigrationCost,P_MAX,V_MAX,Total_TIME
1,1,1,1,0,3582,3582,3582
2,2,4,4,10297,4330,4330,14627
3,3,8,5,18163,3672,3672,21835
4,4,8,3,16197,2798,2798,18995
5,5,7,2,18163,3134,3134,21297
6,6,7,3,14230,809,809,15039
7,7,7,2,14230,1851,1851,16081
8,8,5,2,12263,430,430,12693
9,9,4,2,10297,281,337,10634
10,10,2,2,0,38,38,38
11,11,3,2,0,13,14,14
12,12,1,1,0,2,2,2
13,13,1,1,0,3,3,3
14,14,1,1,0,1,1,1
